일련번호,제품코드,지점,제품명,생산원가,판매금액,이익금
1,D06,서울,디지털카메라,255000,350000,95000
2,T01,인천,TV,567700,730000,162300
3,K02,광주,김치냉장고,650000,850000,200000
4,D06,부산,디지털카메라,88400,120000,31600
5,T01,대전,TV,1250000,1550000,300000
6,D06,인천,디지털카메라,90000,110000,20000
7,K02,서울,김치냉장고,1570000,1840000,270000
8,D06,대전,디지털카메라,489000,650000,161000
9,T01,광주,TV,1890000,2300000,410000
10,K02,부산,김치냉장고,780000,820000,40000
